ncessch,free_lunch_qualified,reduced_price_lunch_qualified,missing,not_applicable,no_category_codes,n
410000301061,83,8,0,0,91,176
410000301062,34,7,0,0,41,39
410000900062,59,8,0,0,67,NA
410000901592,209,30,0,0,239,320
410000901734,0,0,0,0,0,141
410000901784,37,9,0,0,46,175
410000901808,43,11,0,0,54,112
410001400748,218,47,0,0,265,506
410001400754,55,3,0,0,58,140
410001400761,124,29,0,0,153,114
410001401026,49,11,0,0,60,192
410001500821,319,39,0,0,358,422
410001500831,169,22,0,0,191,464
410001500853,186,36,0,0,222,137
410001501588,26,0,0,0,26,11
410001501859,0,0,0,0,0,46
410001601266,114,42,0,0,156,280
410001601288,74,36,0,0,110,116
410001601730,107,34,0,0,141,590
410001900698,167,53,0,0,220,341
410001900731,105,41,0,0,146,115
410001901422,84,25,0,0,109,320
410002000693,95,18,0,0,113,280
410002000765,59,21,0,0,80,381
410002000833,224,41,0,0,265,208
410002000834,298,57,0,0,355,1131
410002000854,229,61,0,0,290,282
410002101166,68,9,0,0,77,120
410002101167,56,15,0,0,71,101
410002300209,129,23,0,0,152,499
410002301168,126,28,0,0,154,381
410002301169,193,24,0,0,217,394
410002301171,313,29,0,0,342,523
410002301172,326,37,0,0,363,562
410002301173,292,29,0,0,321,468
410002301175,263,28,0,0,291,389
410002301199,191,37,0,0,228,441
410002301200,196,15,0,0,211,312
410002301201,126,29,0,0,155,598
410002301202,348,29,0,0,377,580
410002301203,116,8,0,0,124,259
410002301242,80,15,0,0,95,352
410002301243,77,18,0,0,95,404
410002301248,414,132,0,0,546,711
410002301250,228,69,0,0,297,1433
410002301251,271,58,0,0,329,1416
410002301252,539,122,0,0,661,550
410002301253,300,63,0,0,363,1320
410002301295,112,37,0,0,149,564
410002301300,108,25,0,0,133,505
410002301305,219,29,0,0,248,531
410002301306,425,102,0,0,527,730
410002301322,262,63,0,0,325,1533
410002301373,83,28,0,0,111,605
410002301499,156,31,0,0,187,696
410002301500,88,17,0,0,105,501
410002301535,10,9,0,0,19,NA
410002301585,432,122,0,0,554,651
410002301749,393,38,0,0,431,568
410002301750,202,46,0,0,248,498
410002301759,121,17,0,0,138,509
410002301764,232,36,0,0,268,420
410002301824,0,0,0,0,0,145
410002304174,112,34,0,0,146,576
410004000176,131,49,0,0,180,431
410004000179,47,23,0,0,70,NA
410004300494,149,0,0,0,149,34
410004301404,15,0,0,0,15,NA
410004301406,78,0,0,0,78,21
410004301412,0,0,0,0,0,NA
410004301413,0,0,0,0,0,NA
410004301476,0,0,0,0,0,NA
410004301477,7,0,0,0,7,NA
410004301740,21,0,0,0,21,NA
410004301744,31,0,0,0,31,10
410004700862,61,27,0,0,88,188
410004801151,376,29,0,0,405,433
410004801153,65,26,0,0,91,276
410004801155,234,20,0,0,254,366
410004801156,297,32,0,0,329,457
410004801158,404,44,0,0,448,1165
410004801159,392,44,0,0,436,364
410004801833,37,5,0,0,42,NA
410064000233,214,16,0,0,230,360
410064000234,126,22,0,0,148,155
410099000524,0,0,0,0,0,NA
410102000755,84,37,0,0,121,246
410102000756,36,10,0,0,46,14
410112000017,37,9,0,0,46,436
410112000029,28,7,0,0,35,331
410112000031,18,1,0,0,19,NA
410112000669,86,13,0,0,99,304
410112000670,188,42,0,0,230,308
410112000671,88,18,0,0,106,352
410112000672,145,25,0,0,170,324
410112000673,255,43,0,0,298,369
410112000674,221,39,0,0,260,378
410112000675,70,7,0,0,77,NA
410112000676,206,16,0,0,222,280
410112000680,176,53,0,0,229,485
410112000692,83,21,0,0,104,170
410112000725,91,15,0,0,106,NA
410112000732,267,60,0,0,327,1054
410112000733,240,46,0,0,286,1106
410112000734,187,34,0,0,221,1167
410112000735,198,72,0,0,270,619
410112000736,376,108,0,0,484,583
410112001577,71,12,0,0,83,44
410112001773,185,54,0,0,239,1406
410120000019,84,23,0,0,107,98
410123001260,184,37,0,0,221,376
410123001263,145,29,0,0,174,110
410123001320,91,18,0,0,109,351
410123001653,0,0,0,0,0,NA
410135000753,56,14,0,0,70,104
410147000343,83,27,0,0,110,116
410150000759,0,0,0,0,0,NA
410156000395,90,17,0,0,107,333
410156000397,77,14,0,0,91,354
410156000399,113,6,0,0,119,321
410156000400,165,26,0,0,191,1094
410156000401,257,45,0,0,302,440
410156001654,31,6,0,0,37,55
410159000448,0,0,0,0,0,NA
410162000152,166,40,0,0,206,NA
410162000153,220,45,0,0,265,813
410162000155,186,50,0,0,236,240
410162000156,175,50,0,0,225,823
410166001112,91,16,0,0,107,88
410166001114,113,31,0,0,144,464
410166001115,58,12,0,0,70,87
410171000001,104,22,0,0,126,422
410171000002,260,36,0,0,296,218
410171000007,175,27,0,0,202,678
410171000009,142,34,0,0,176,173
410171000030,50,8,0,0,58,138
410171000034,0,0,0,0,0,NA
410171001516,0,0,0,0,0,NA
410171001767,0,0,0,0,0,1345
410171001783,0,0,0,0,0,105
410174000013,16,6,0,0,22,NA
410180000235,136,22,0,0,158,453
410180000236,126,22,0,0,148,218
410180000237,94,21,0,0,115,67
410183001176,122,19,0,0,141,478
410183001179,72,12,0,0,84,518
410183001180,56,17,0,0,73,170
410192000210,93,17,0,0,110,593
410192000213,106,39,0,0,145,768
410192000220,116,19,0,0,135,42
410192000536,0,0,0,0,0,71
410192000552,259,51,0,0,310,1829
410192000554,564,127,0,0,691,767
410192001204,580,132,0,0,712,1119
410192001205,344,63,0,0,407,615
410192001206,340,79,0,0,419,671
410192001207,72,4,0,0,76,517
410192001210,47,7,0,0,54,413
410192001211,251,44,0,0,295,450
410192001212,80,11,0,0,91,512
410192001213,187,34,0,0,221,435
410192001215,189,45,0,0,234,453
410192001216,154,29,0,0,183,631
410192001217,361,88,0,0,449,739
410192001219,143,30,0,0,173,312
410192001220,328,48,0,0,376,553
410192001222,62,11,0,0,73,338
410192001223,76,16,0,0,92,550
410192001224,217,32,0,0,249,679
410192001225,128,17,0,0,145,376
410192001226,72,14,0,0,86,445
410192001227,91,32,0,0,123,547
410192001229,102,31,0,0,133,378
410192001230,410,91,0,0,501,567
410192001231,36,4,0,0,40,258
410192001232,362,29,0,0,391,430
410192001233,226,45,0,0,271,1907
410192001234,520,121,0,0,641,1942
410192001235,316,57,0,0,373,1594
410192001236,388,90,0,0,478,1635
410192001237,240,49,0,0,289,1598
410192001238,331,73,0,0,404,1292
410192001239,921,239,0,0,1160,886
410192001240,721,127,0,0,848,697
410192001241,351,88,0,0,439,782
410192001262,30,10,0,0,40,831
410192001289,214,30,0,0,244,338
410192001301,134,44,0,0,178,472
410192001321,288,47,0,0,335,618
410192001430,75,15,0,0,90,551
410192001431,134,35,0,0,169,2898
410192001432,425,111,0,0,536,860
410192001445,38,4,0,0,42,242
410192001647,110,44,0,0,154,1044
410192001745,311,78,0,0,389,876
410192001753,58,6,0,0,64,651
410192001779,108,18,0,0,126,1002
410192001791,28,1,0,0,29,283
410192001823,0,0,0,0,0,NA
410192001855,168,32,0,0,200,NA
410192001856,53,14,0,0,67,465
410192011348,72,19,0,0,91,523
410198000245,233,60,0,0,293,582
410198000258,367,35,0,0,402,571
410198000259,142,43,0,0,185,1213
410198000262,250,30,0,0,280,442
410198000263,292,64,0,0,356,1379
410198000264,185,32,0,0,217,559
410198000265,215,61,0,0,276,513
410198000266,193,41,0,0,234,551
410198000268,309,82,0,0,391,1204
410198000270,630,165,0,0,795,287
410198000271,428,127,0,0,555,NA
410198000272,212,66,0,0,278,NA
410198000546,140,31,0,0,171,588
410198000607,22,11,0,0,33,110
410198000688,110,8,0,0,118,33
410198001290,152,59,0,0,211,516
410198001350,170,50,0,0,220,581
410198001436,25,14,0,0,39,284
410198001438,22,11,0,0,33,NA
410198001451,194,67,0,0,261,NA
410198001454,94,29,0,0,123,24
410198001487,44,12,0,0,56,656
410198001488,170,60,0,0,230,666
410198001576,114,38,0,0,152,512
410198001603,135,16,0,0,151,174
410198001747,180,58,0,0,238,572
410198001758,64,15,0,0,79,634
410198001794,156,17,0,0,173,166
410198001839,68,11,0,0,79,1364
410198001844,174,50,0,0,224,408
410198001845,45,15,0,0,60,134
410198001860,0,0,0,0,0,NA
410204000616,147,19,0,0,166,252
410204000617,202,24,0,0,226,274
410204000618,271,39,0,0,310,330
410204000619,111,36,0,0,147,380
410204000620,242,49,0,0,291,441
410204000621,192,50,0,0,242,609
410204000622,180,41,0,0,221,749
410204000623,601,143,0,0,744,544
410204001391,246,70,0,0,316,1014
410204004178,43,8,0,0,51,27
410204004179,349,89,0,0,438,917
410216000641,110,18,0,0,128,250
410219000449,0,0,0,0,0,NA
410231000253,152,28,0,0,180,639
410231000254,358,54,0,0,412,658
410231000255,197,58,0,0,255,244
410249000361,179,60,0,0,239,406
410249000363,58,35,0,0,93,389
410249000379,92,36,0,0,128,49
410249001520,0,0,0,0,0,NA
410258000426,153,30,0,0,183,212
410261000315,124,23,0,0,147,223
410264000100,160,16,0,0,176,537
410264000130,150,19,0,0,169,394
410264000132,117,22,0,0,139,497
410264000135,138,21,0,0,159,583
410264000148,413,42,0,0,455,359
410264000165,251,31,0,0,282,343
410264001651,242,31,0,0,273,972
410264001659,177,19,0,0,196,435
410278000767,283,26,0,0,309,559
410278000835,84,17,0,0,101,295
410278000851,32,12,0,0,44,178
410278000855,203,40,0,0,243,1065
410278000856,213,48,0,0,261,323
410278001854,30,3,0,0,33,14
410280001012,260,29,0,0,289,466
410280001013,541,97,0,0,638,1692
410280001015,349,0,0,0,349,471
410280001016,326,0,0,0,326,400
410280001017,324,78,0,0,402,608
410280001018,462,0,0,0,462,545
410280001019,159,45,0,0,204,509
410280001020,877,181,0,0,1058,791
410280001221,96,8,0,0,104,28
410280001574,229,50,0,0,279,604
410284001054,260,50,0,0,310,446
410284001055,228,28,0,0,256,518
410284001057,374,73,0,0,447,1507
410284001058,391,62,0,0,453,399
410284001461,295,62,0,0,357,573
410291000475,196,19,0,0,215,355
410291000729,155,31,0,0,186,307
410294000402,295,56,0,0,351,524
410294000403,361,37,0,0,398,578
410294000404,183,22,0,0,205,236
410294000405,228,35,0,0,263,524
410294000406,221,13,0,0,234,327
410294000407,126,17,0,0,143,442
410294000408,289,65,0,0,354,1524
410294001720,114,32,0,0,146,189
410294001728,133,22,0,0,155,196
410294001739,191,49,0,0,240,199
410326000173,180,52,0,0,232,340
410326000178,144,27,0,0,171,232
410326500181,237,41,0,0,278,548
410326500184,153,39,0,0,192,342
410326501670,23,4,0,0,27,13
410327000109,66,25,0,0,91,296
410327000110,37,10,0,0,47,105
410327001343,27,14,0,0,41,284
410333000345,19,27,0,0,46,44
410333000346,10,4,0,0,14,NA
410339000200,44,5,0,0,49,NA
410339000202,142,21,0,0,163,321
410339001589,208,35,0,0,243,530
410339001804,176,13,0,0,189,181
410342001729,234,72,0,0,306,1263
410348000032,107,12,0,0,119,431
410348000033,153,26,0,0,179,1114
410348000037,215,49,0,0,264,389
410348000040,76,9,0,0,85,422
410348000042,85,11,0,0,96,328
410348000043,168,46,0,0,214,356
410348000044,110,18,0,0,128,325
410348000045,261,73,0,0,334,1386
410348000046,186,31,0,0,217,476
410348000047,366,84,0,0,450,416
410348000048,207,42,0,0,249,435
410348000570,53,10,0,0,63,347
410348001743,0,0,0,0,0,NA
410354001139,100,13,0,0,113,223
410360000365,33,21,0,0,54,62
410363000378,17,15,0,0,32,NA
410366000204,290,48,0,0,338,291
410366000211,276,32,0,0,308,200
410366000214,246,33,0,0,279,918
410366000215,323,37,0,0,360,784
410366000216,446,91,0,0,537,744
410366001486,55,9,0,0,64,12
410366001602,44,7,0,0,51,30
410366004188,47,22,0,0,69,201
410369000604,257,53,0,0,310,565
410369000605,108,26,0,0,134,521
410369000606,123,26,0,0,149,177
410372000238,268,59,0,0,327,621
410372000241,8,5,0,0,13,NA
410372000242,0,0,0,0,0,124
410372000243,249,45,0,0,294,1141
410372000244,264,54,0,0,318,308
410372001682,48,3,0,0,51,23
410372001840,328,55,0,0,383,662
410372001841,0,0,0,0,0,NA
410378000624,30,16,0,0,46,NA
410378000627,43,5,0,0,48,NA
410384000119,96,19,0,0,115,308
410384000446,160,35,0,0,195,314
410384000447,90,25,0,0,115,99
410386001043,192,33,0,0,225,215
410386001044,146,39,0,0,185,145
410386001045,97,11,0,0,108,157
410386001047,185,44,0,0,229,848
410386001049,256,57,0,0,313,1213
410386001050,261,70,0,0,331,362
410386001835,0,0,0,0,0,NA
410394001025,341,52,0,0,393,438
410394001027,541,107,0,0,648,1558
410394001028,390,86,0,0,476,1370
410394001029,401,66,0,0,467,588
410394001030,357,66,0,0,423,643
410394001031,434,50,0,0,484,624
410394001032,304,56,0,0,360,454
410394001033,358,44,0,0,402,529
410394001035,262,41,0,0,303,434
410394001036,316,57,0,0,373,463
410394001037,1793,377,0,0,2170,1397
410394001676,596,121,0,0,717,1587
410394004180,340,75,0,0,415,437
410394004181,48,15,0,0,63,146
410396000308,101,31,0,0,132,90
410399000228,124,31,0,0,155,441
410399001264,250,40,0,0,290,444
410399001265,177,26,0,0,203,182
410402000358,27,8,0,0,35,NA
410417000367,0,0,0,0,0,NA
410429000372,0,0,0,0,0,NA
410435000316,130,26,0,0,156,307
410435000317,49,3,0,0,52,NA
410438000369,0,0,0,0,0,NA
410441001162,141,40,0,0,181,345
410450000410,242,37,0,0,279,520
410450000413,177,25,0,0,202,351
410450000414,503,62,0,0,565,694
410450000416,162,37,0,0,199,886
410450000417,459,63,0,0,522,473
410450001416,16,1,0,0,17,20
410450001586,114,26,0,0,140,336
410450001587,240,22,0,0,262,668
410450001681,39,0,0,0,39,14
410450001831,76,19,0,0,95,222
410453001089,118,36,0,0,154,297
410459001140,158,54,0,0,212,238
410459001141,74,19,0,0,93,136
410462000322,131,28,0,0,159,266
410470000139,163,37,0,0,200,430
410470000140,167,43,0,0,210,340
410470000142,176,23,0,0,199,590
410470000143,197,40,0,0,237,225
410470001766,0,0,0,0,0,298
410470001778,0,0,0,0,0,58
410474000530,160,40,0,0,200,404
410474000531,206,21,0,0,227,390
410474000533,0,0,0,0,0,NA
410474000537,116,16,0,0,132,429
410474000538,129,22,0,0,151,295
410474000542,193,40,0,0,233,601
410474000544,311,43,0,0,354,459
410474000548,211,25,0,0,236,337
410474000550,234,32,0,0,266,266
410474000553,143,21,0,0,164,285
410474000555,92,15,0,0,107,255
410474000559,212,29,0,0,241,513
410474000561,143,29,0,0,172,1027
410474000562,235,42,0,0,277,605
410474000564,162,34,0,0,196,654
410474000565,186,33,0,0,219,818
410474000566,201,49,0,0,250,947
410474000567,132,16,0,0,148,57
410474000568,134,25,0,0,159,894
410474000569,112,24,0,0,136,624
410474000571,395,106,0,0,501,371
410474000572,353,85,0,0,438,538
410474000573,274,93,0,0,367,467
410474000575,403,129,0,0,532,513
410474000690,69,16,0,0,85,133
410474001344,51,10,0,0,61,332
410474001345,132,20,0,0,152,407
410474001348,0,0,0,0,0,288
410474001359,165,39,0,0,204,210
410474001491,0,0,0,0,0,310
410474001492,77,43,0,0,120,180
410474001593,71,13,0,0,84,64
410474001604,307,27,0,0,334,409
410474001609,285,43,0,0,328,597
410474001737,244,33,0,0,277,628
410474001781,140,34,0,0,174,329
410474001848,0,0,0,0,0,NA
410474001858,0,0,0,0,0,NA
410495000597,109,33,0,0,142,311
410495000599,152,28,0,0,180,351
410495000600,140,39,0,0,179,657
410495000601,139,47,0,0,186,163
410495001595,0,0,0,0,0,54
410502001383,0,0,0,0,0,NA
410508001148,60,31,0,0,91,245
410508001149,38,34,0,0,72,174
410510000643,173,33,0,0,206,646
410510000644,347,48,0,0,395,630
410510000645,213,43,0,0,256,208
410516001182,218,22,0,0,240,238
410516001183,60,6,0,0,66,190
410516001184,273,70,0,0,343,473
410516001186,154,30,0,0,184,390
410516001187,287,50,0,0,337,386
410516001188,417,69,0,0,486,1617
410516001189,770,150,0,0,920,884
410516001339,346,50,0,0,396,1514
410516001578,285,9,0,0,294,307
410516001724,33,10,0,0,43,48
410525001375,30,8,0,0,38,640
410531000370,0,0,0,0,0,NA
410531001756,0,0,0,0,0,NA
410543001247,89,12,0,0,101,272
410543001249,75,9,0,0,84,284
410561000144,269,82,0,0,351,925
410561000145,162,51,0,0,213,880
410561000146,176,71,0,0,247,302
410561001774,61,15,0,0,76,NA
410564000326,135,12,0,0,147,215
410564000327,62,18,0,0,80,21
410567000302,182,36,0,0,218,481
410567000303,42,7,0,0,49,206
410567000305,57,28,0,0,85,88
410576000249,148,54,0,0,202,356
410576000257,74,22,0,0,96,66
410591000457,237,35,0,0,272,516
410591000458,226,22,0,0,248,485
410591000459,284,49,0,0,333,461
410591000460,427,88,0,0,515,1463
410591000461,269,46,0,0,315,475
410591000462,330,28,0,0,358,416
410591000463,332,72,0,0,404,1320
410591000464,798,130,0,0,928,785
410591000970,313,47,0,0,360,449
410600000098,64,20,0,0,84,538
410600000525,351,98,0,0,449,1201
410600000534,326,35,0,0,361,554
410600000988,280,47,0,0,327,1021
410600000989,318,25,0,0,343,406
410600000990,335,80,0,0,415,1528
410600000991,428,37,0,0,465,449
410600000992,371,49,0,0,420,524
410600000993,227,33,0,0,260,453
410600000994,169,13,0,0,182,248
410600000995,99,26,0,0,125,464
410600000996,135,36,0,0,171,909
410600001040,706,171,0,0,877,662
410600001041,468,129,0,0,597,636
410600001303,288,52,0,0,340,395
410600001304,320,41,0,0,361,420
410600001571,0,0,0,0,0,NA
410600001733,30,26,0,0,56,158
410600001757,56,70,0,0,126,117
410600001787,0,0,0,0,0,394
410600004182,387,31,0,0,418,599
410600004183,76,25,0,0,101,45
410612000758,57,15,0,0,72,74
410627001084,33,11,0,0,44,127
410630000677,276,79,0,0,355,1027
410630001093,333,78,0,0,411,490
410630001094,413,56,0,0,469,602
410630001095,395,83,0,0,478,555
410630001096,440,90,0,0,530,1500
410630001097,765,195,0,0,960,792
410630001293,212,48,0,0,260,444
410630001439,302,71,0,0,373,608
410651000382,176,27,0,0,203,445
410651000383,320,83,0,0,403,481
410651000384,136,7,0,0,143,185
410651000386,146,38,0,0,184,491
410651000387,178,43,0,0,221,1011
410651000388,247,40,0,0,287,698
410651000389,43,7,0,0,50,56
410651000390,504,126,0,0,630,626
410660000011,61,10,0,0,71,27
410663001137,63,48,0,0,111,298
410671000769,198,43,0,0,241,388
410671000770,106,47,0,0,153,128
410671001294,99,24,0,0,123,390
410674000451,305,22,0,0,327,412
410674000452,223,20,0,0,243,306
410674000454,627,0,0,0,627,745
410674000456,435,43,0,0,478,270
410674000656,327,28,0,0,355,882
410674001446,0,0,0,0,0,NA
410674001569,222,16,0,0,238,323
410674001852,58,0,0,0,58,36
410675000158,69,11,0,0,80,122
410678000347,120,49,0,0,169,360
410678000349,11,2,0,0,13,NA
410678000350,80,50,0,0,130,252
410682000697,0,0,0,0,0,NA
410682000760,0,0,0,0,0,NA
410682001423,0,0,0,0,0,NA
410687001142,0,0,0,0,0,NA
410687001145,96,13,0,0,109,215
410690000422,45,5,0,0,50,54
410690000465,304,28,0,0,332,300
410690000466,195,19,0,0,214,715
410690000467,220,37,0,0,257,374
410690000468,131,18,0,0,149,286
410690000470,215,44,0,0,259,597
410690000471,210,22,0,0,232,575
410690000472,224,37,0,0,261,377
410690000473,238,27,0,0,265,393
410690000477,41,12,0,0,53,70
410690000479,201,43,0,0,244,248
410690000480,217,33,0,0,250,105
410690000481,189,38,0,0,227,213
410690001797,63,13,0,0,76,104
410690001812,0,0,0,0,0,169
410693000203,42,9,0,0,51,144
410693000630,188,45,0,0,233,375
410693000631,185,50,0,0,235,948
410693000632,163,52,0,0,215,181
410696000747,0,0,0,0,0,NA
410702000492,140,8,0,0,148,148
410702000495,272,35,0,0,307,508
410702000496,11,0,0,0,11,NA
410702000498,219,86,0,0,305,656
410702000499,103,17,0,0,120,203
410702000500,95,10,0,0,105,164
410702000501,100,6,0,0,106,166
410702000502,290,67,0,0,357,676
410702000503,271,45,0,0,316,615
410702000504,245,29,0,0,274,372
410702000505,303,45,0,0,348,734
410702000506,219,31,0,0,250,705
410702000508,111,7,0,0,118,127
410702000510,198,53,0,0,251,298
410702000511,151,10,0,0,161,234
410702000513,382,84,0,0,466,296
410702001464,160,20,0,0,180,243
410702001465,96,5,0,0,101,132
410702001466,141,18,0,0,159,183
410702001467,45,8,0,0,53,67
410702001688,31,8,0,0,39,43
410702001807,37,6,0,0,43,18
410708000483,239,41,0,0,280,374
410708000485,342,18,0,0,360,354
410708000486,181,22,0,0,203,295
410708000487,415,43,0,0,458,1190
410708000489,178,19,0,0,197,356
410708000512,358,31,0,0,389,284
410708001687,119,17,0,0,136,94
410708001847,0,0,0,0,0,38
410720001125,215,38,0,0,253,469
410720001126,209,23,0,0,232,328
410720001127,219,43,0,0,262,987
410720001128,143,17,0,0,160,328
410720001131,205,35,0,0,240,290
410723000060,26,5,0,0,31,290
410723000061,22,7,0,0,29,131
410723000064,53,12,0,0,65,515
410723000066,57,14,0,0,71,1718
410723000067,53,13,0,0,66,1680
410723000068,84,17,0,0,101,478
410723000069,57,18,0,0,75,540
410723001307,26,0,0,0,26,NA
410723001308,21,6,0,0,27,378
410723001378,58,6,0,0,64,589
410728000514,19,1,0,0,20,NA
410728000517,169,28,0,0,197,408
410728000519,88,20,0,0,108,144
410728000689,43,9,0,0,52,201
410738000682,193,20,0,0,213,332
410738000684,205,28,0,0,233,294
410738000696,124,22,0,0,146,408
410738000710,89,21,0,0,110,284
410738000714,313,36,0,0,349,1205
410738000730,488,64,0,0,552,515
410738004184,214,22,0,0,236,420
410738004185,190,27,0,0,217,426
410738004186,137,24,0,0,161,338
410750000646,274,28,0,0,302,444
410750000651,198,25,0,0,223,NA
410750000653,226,0,0,0,226,NA
410750000655,342,58,0,0,400,923
410750000657,203,32,0,0,235,362
410750000658,46,4,0,0,50,157
410750000660,248,21,0,0,269,875
410750000661,226,25,0,0,251,727
410750000663,285,39,0,0,324,NA
410750000665,241,47,0,0,288,7
410750000666,106,16,0,0,122,NA
410750000667,92,8,0,0,100,82
410750000984,134,26,0,0,160,311
410750001334,51,8,0,0,59,199
410750001493,0,0,0,0,0,NA
410750001582,83,17,0,0,100,216
410750001590,100,6,0,0,106,129
410750001660,0,0,0,0,0,15
410753000360,16,0,0,0,16,16
410759000633,124,17,0,0,141,206
410759000634,89,14,0,0,103,148
410759001834,28,10,0,0,38,84
410759001846,0,0,0,0,0,228
410771000602,51,6,0,0,57,82
410771000603,49,6,0,0,55,76
410774000638,56,16,0,0,72,141
410774000639,52,9,0,0,61,46
410798000628,103,2,0,0,105,167
410798000629,46,1,0,0,47,30
410801000540,342,44,0,0,386,1445
410801001279,283,29,0,0,312,526
410801001281,248,22,0,0,270,613
410801001282,318,17,0,0,335,531
410801001283,434,77,0,0,511,1509
410801001284,878,116,0,0,994,982
410801001310,236,40,0,0,276,412
410801001433,320,36,0,0,356,577
410801001752,347,31,0,0,378,493
410804000428,219,37,0,0,256,646
410804000429,165,20,0,0,185,861
410804000430,331,40,0,0,371,501
410804000431,368,19,0,0,387,468
410804000432,122,9,0,0,131,492
410804000433,370,38,0,0,408,524
410804000434,168,41,0,0,209,643
410804000435,342,43,0,0,385,564
410804000436,296,39,0,0,335,580
410804000437,286,18,0,0,304,436
410804000438,83,16,0,0,99,284
410804000439,326,31,0,0,357,471
410804000441,396,38,0,0,434,612
410804000442,367,46,0,0,413,1848
410804000443,435,63,0,0,498,1592
410804000444,675,130,0,0,805,728
410804000445,629,82,0,0,711,716
410804000963,159,35,0,0,194,610
410804001736,54,3,0,0,57,238
410804001796,0,0,0,0,0,928
410804001829,268,38,0,0,306,482
410804001843,10,1,0,0,11,70
410804004187,166,15,0,0,181,55
410810000722,143,17,0,0,160,339
410810000724,121,14,0,0,135,253
410810001680,0,0,0,0,0,3144
410816001116,261,57,0,0,318,819
410816001123,288,60,0,0,348,226
410816001836,182,42,0,0,224,238
410816001837,159,26,0,0,185,NA
410816001842,198,37,0,0,235,568
410828001259,19,3,0,0,22,NA
410828001813,0,0,0,0,0,235
410831000101,41,10,0,0,51,NA
410831000102,207,48,0,0,255,972
410831000129,87,15,0,0,102,164
410831000136,83,16,0,0,99,125
410831000151,215,50,0,0,265,369
410831001325,226,44,0,0,270,411
410831001789,15,12,0,0,27,NA
410831001800,0,0,0,0,0,NA
410843000027,122,28,0,0,150,324
410843000050,48,9,0,0,57,60
410846000356,24,6,0,0,30,NA
410852000858,158,50,0,0,208,166
410852000859,67,15,0,0,82,162
410852000861,45,18,0,0,63,158
410852000863,286,41,0,0,327,371
410852001311,249,44,0,0,293,170
410852001312,236,38,0,0,274,328
410852001597,183,32,0,0,215,495
410852001598,153,20,0,0,173,408
410855000837,84,18,0,0,102,342
410855000838,179,30,0,0,209,385
410855000839,98,27,0,0,125,76
410865001078,94,11,0,0,105,188
410865001080,74,15,0,0,89,198
410865001081,85,7,0,0,92,102
410865001656,80,16,0,0,96,380
410870001077,127,36,0,0,163,256
410870001082,102,44,0,0,146,216
410872001269,86,9,0,0,95,268
410872001270,346,27,0,0,373,466
410872001271,44,7,0,0,51,199
410872001272,149,24,0,0,173,519
410872001273,182,39,0,0,221,955
410872001274,359,59,0,0,418,701
410872001291,99,16,0,0,115,488
410872001309,151,44,0,0,195,1025
410872001674,142,25,0,0,167,354
410882000219,240,47,0,0,287,435
410882000221,301,27,0,0,328,503
410882000224,253,59,0,0,312,1088
410882000225,276,85,0,0,361,341
410882001751,0,0,0,0,0,1459
410883000008,100,42,0,0,142,473
410883000070,164,37,0,0,201,388
410883000072,158,52,0,0,210,371
410883000076,26,20,0,0,46,148
410883000079,169,27,0,0,196,304
410883000080,323,42,0,0,365,408
410883000081,55,13,0,0,68,153
410883000084,177,37,0,0,214,445
410883000085,182,44,0,0,226,344
410883000086,138,42,0,0,180,602
410883000087,126,32,0,0,158,428
410883000092,373,79,0,0,452,1387
410883000093,266,125,0,0,391,1147
410883000094,481,123,0,0,604,356
410883000095,329,102,0,0,431,470
410883001317,16,3,0,0,19,96
410883001354,73,26,0,0,99,387
410883001379,203,59,0,0,262,1637
410883001483,74,23,0,0,97,599
410883001484,168,22,0,0,190,313
410883001543,0,0,0,0,0,267
410883001544,0,0,0,0,0,120
410883001583,82,14,0,0,96,13
410883001584,119,37,0,0,156,217
410883001658,14,11,0,0,25,96
410883001686,0,0,0,0,0,118
410883001775,58,30,0,0,88,507
410883001777,141,30,0,0,171,583
410883001782,115,64,0,0,179,2108
410883004189,347,102,0,0,449,1729
410888000771,201,52,0,0,253,794
410888000772,236,65,0,0,301,282
410888001326,226,50,0,0,276,910
410888001424,190,55,0,0,245,NA
410894001135,148,32,0,0,180,273
410900000750,356,62,0,0,418,530
410900000751,164,29,0,0,193,504
410900000752,214,37,0,0,251,169
410912000285,102,15,0,0,117,398
410912000286,119,18,0,0,137,174
410912000287,76,14,0,0,90,72
410915000635,206,16,0,0,222,344
410915000636,61,9,0,0,70,146
410915000637,97,18,0,0,115,66
410927000739,301,31,0,0,332,484
410927000740,114,7,0,0,121,150
410927000741,233,9,0,0,242,305
410927000743,336,14,0,0,350,476
410927000744,94,6,0,0,100,98
410927000745,224,21,0,0,245,637
410927000746,430,37,0,0,467,332
410933000112,143,33,0,0,176,569
410933000113,131,31,0,0,162,518
410933000114,242,24,0,0,266,504
410933000116,170,37,0,0,207,516
410933000117,126,29,0,0,155,NA
410933000122,108,22,0,0,130,595
410933000123,246,49,0,0,295,1518
410933000124,274,51,0,0,325,1635
410933000126,566,126,0,0,692,899
410933000147,169,30,0,0,199,555
410933001642,0,0,0,0,0,NA
410933001666,90,10,0,0,100,58
410933001725,0,0,0,0,0,154
410933001793,47,18,0,0,65,123
410943000521,0,0,0,0,0,100
410948000979,229,23,0,0,252,331
410948000980,309,0,0,0,309,402
410948000981,200,35,0,0,235,340
410948000982,246,27,0,0,273,340
410948000986,508,77,0,0,585,1440
410948000987,560,114,0,0,674,398
410951001105,78,15,0,0,93,364
410951001106,263,36,0,0,299,556
410951001107,233,22,0,0,255,535
410951001111,245,44,0,0,289,387
410951001327,297,59,0,0,356,1456
410951001534,48,7,0,0,55,38
410951001689,0,0,0,0,0,27
410951001838,218,22,0,0,240,NA
410953001060,73,32,0,0,105,299
410960000020,7,2,0,0,9,24
410960000021,92,10,0,0,102,94
410960000022,117,35,0,0,152,564
410960000023,106,41,0,0,147,658
410960000024,105,43,0,0,148,232
410960001481,61,11,0,0,72,NA
410963000391,279,29,0,0,308,387
410963000392,262,26,0,0,288,455
410963000393,306,30,0,0,336,1052
410963000394,331,34,0,0,365,324
410963001335,255,24,0,0,279,361
410963001489,37,6,0,0,43,15
410966001085,93,31,0,0,124,178
410966001086,77,23,0,0,100,131
410969000366,0,0,0,0,0,NA
410972000016,98,29,0,0,127,153
410975000427,0,0,0,0,0,NA
410987000527,142,37,0,0,179,412
410987000529,133,44,0,0,177,589
410996000523,0,0,0,0,0,NA
411002000246,121,4,0,0,125,174
411002000247,30,7,0,0,37,36
411004000371,34,9,0,0,43,350
411004000865,41,12,0,0,53,485
411004000866,40,10,0,0,50,604
411004000867,38,3,0,0,41,587
411004000869,169,25,0,0,194,506
411004000870,132,39,0,0,171,471
411004000871,105,16,0,0,121,401
411004000872,239,18,0,0,257,234
411004000873,152,23,0,0,175,391
411004000874,191,16,0,0,207,952
411004000876,350,49,0,0,399,473
411004000877,206,27,0,0,233,569
411004000878,66,10,0,0,76,487
411004000880,106,24,0,0,130,352
411004000881,76,13,0,0,89,414
411004000882,142,16,0,0,158,536
411004000883,103,18,0,0,121,285
411004000884,451,21,0,0,472,644
411004000885,492,45,0,0,537,823
411004000886,141,24,0,0,165,385
411004000887,37,6,0,0,43,351
411004000890,457,48,0,0,505,489
411004000893,339,20,0,0,359,775
411004000894,69,12,0,0,81,443
411004000896,85,11,0,0,96,1027
411004000898,187,21,0,0,208,328
411004000899,98,8,0,0,106,438
411004000901,79,9,0,0,88,1039
411004000902,144,30,0,0,174,1068
411004000905,100,10,0,0,110,344
411004000906,240,22,0,0,262,344
411004000909,343,47,0,0,390,507
411004000911,300,28,0,0,328,314
411004000912,319,29,0,0,348,778
411004000913,63,6,0,0,69,889
411004000914,279,33,0,0,312,514
411004000915,386,50,0,0,436,567
411004000916,81,7,0,0,88,274
411004000917,44,12,0,0,56,442
411004000918,52,11,0,0,63,332
411004000919,192,13,0,0,205,413
411004000920,272,29,0,0,301,436
411004000922,116,19,0,0,135,1234
411004000925,248,39,0,0,287,839
411004000926,128,20,0,0,148,179
411004000930,36,8,0,0,44,212
411004000931,352,29,0,0,381,426
411004000932,218,39,0,0,257,594
411004000933,91,12,0,0,103,607
411004000935,402,29,0,0,431,467
411004000936,57,6,0,0,63,1074
411004000937,294,18,0,0,312,215
411004000938,50,6,0,0,56,324
411004000940,25,5,0,0,30,111
411004000941,108,22,0,0,130,738
411004000944,172,16,0,0,188,549
411004000945,226,19,0,0,245,391
411004000947,64,12,0,0,76,1699
411004000949,194,30,0,0,224,254
411004000952,228,30,0,0,258,291
411004000953,224,19,0,0,243,241
411004000954,135,33,0,0,168,515
411004000956,484,93,0,0,577,362
411004000958,259,49,0,0,308,214
411004000960,605,143,0,0,748,547
411004000962,171,30,0,0,201,264
411004000964,387,40,0,0,427,199
411004000966,127,37,0,0,164,647
411004000967,67,11,0,0,78,181
411004000968,686,77,0,0,763,243
411004000975,250,37,0,0,287,15
411004001079,93,34,0,0,127,748
411004001102,36,18,0,0,54,174
411004001365,134,21,0,0,155,1238
411004001395,25,0,0,0,25,NA
411004001435,0,0,0,0,0,NA
411004001581,5,3,0,0,8,NA
411004001649,84,28,0,0,112,217
411004001652,99,10,0,0,109,79
411004001667,6,56,0,0,62,168
411004001765,114,30,0,0,144,551
411004001814,16,2,0,0,18,NA
411004001821,523,55,0,0,578,337
411004001830,59,12,0,0,71,26
411004004190,0,0,0,0,0,216
411008000226,48,0,0,0,48,96
411008000227,32,0,0,0,32,30
411011000352,73,18,0,0,91,50
411020000111,150,16,0,0,166,223
411035000277,286,16,0,0,302,454
411035000278,267,18,0,0,285,448
411035000279,156,29,0,0,185,405
411035000280,114,29,0,0,143,432
411035000281,280,66,0,0,346,1127
411035000282,535,114,0,0,649,418
411035000647,287,50,0,0,337,1206
411035000942,272,20,0,0,292,424
411035001347,213,46,0,0,259,596
411035001645,201,37,0,0,238,538
411035001785,116,51,0,0,167,NA
411035001820,380,104,0,0,484,284
411035001850,191,39,0,0,230,NA
411041000329,214,26,0,0,240,359
411041000330,195,25,0,0,220,257
411052000997,432,20,0,0,452,472
411052000998,254,27,0,0,281,395
411052000999,449,35,0,0,484,405
411052001000,408,27,0,0,435,467
411052001001,296,29,0,0,325,440
411052001003,408,26,0,0,434,352
411052001004,160,45,0,0,205,369
411052001005,201,41,0,0,242,367
411052001006,352,30,0,0,382,420
411052001007,539,55,0,0,594,1363
411052001009,1283,198,0,0,1481,1079
411052001010,671,64,0,0,735,1695
411052001209,288,43,0,0,331,406
411052001397,260,69,0,0,329,1115
411052001434,81,14,0,0,95,786
411052001471,151,11,0,0,162,54
411052001540,51,6,0,0,57,220
411052001579,363,24,0,0,387,408
411052001798,178,23,0,0,201,251
411053000324,143,30,0,0,173,274
411053000325,89,16,0,0,105,140
411056000892,0,0,0,0,0,NA
411056001039,0,0,0,0,0,46
411068000419,246,52,0,0,298,515
411068000421,179,37,0,0,216,337
411068001811,0,0,0,0,0,41
411071000288,236,44,0,0,280,435
411071000289,236,22,0,0,258,247
411071000290,219,25,0,0,244,363
411071000291,148,39,0,0,187,246
411071000292,116,52,0,0,168,464
411071000293,97,28,0,0,125,376
411071000296,178,38,0,0,216,264
411071000297,261,24,0,0,285,327
411071000298,329,90,0,0,419,1334
411071000299,304,70,0,0,374,1177
411071000300,624,136,0,0,760,678
411071001685,0,0,0,0,0,NA
411071001853,0,0,0,0,0,NA
411082000547,404,43,0,0,447,603
411082000659,269,67,0,0,336,1562
411082000664,813,85,0,0,898,1952
411082000668,792,128,0,0,920,2045
411082000774,518,36,0,0,554,702
411082000777,88,17,0,0,105,265
411082000778,207,19,0,0,226,253
411082000779,80,15,0,0,95,337
411082000780,127,27,0,0,154,401
411082000781,222,39,0,0,261,460
411082000782,238,35,0,0,273,380
411082000783,186,20,0,0,206,401
411082000784,398,38,0,0,436,517
411082000786,267,58,0,0,325,395
411082000787,483,40,0,0,523,582
411082000789,380,14,0,0,394,398
411082000790,327,38,0,0,365,436
411082000791,234,52,0,0,286,575
411082000792,343,27,0,0,370,434
411082000793,456,67,0,0,523,710
411082000795,179,36,0,0,215,364
411082000796,133,16,0,0,149,340
411082000797,406,38,0,0,444,553
411082000799,164,36,0,0,200,359
411082000800,201,30,0,0,231,536
411082000801,352,24,0,0,376,420
411082000802,234,39,0,0,273,551
411082000803,255,26,0,0,281,364
411082000805,155,32,0,0,187,320
411082000806,135,33,0,0,168,448
411082000807,124,24,0,0,148,534
411082000808,399,55,0,0,454,509
411082000809,350,27,0,0,377,411
411082000811,348,59,0,0,407,1799
411082000812,405,65,0,0,470,1491
411082000813,531,62,0,0,593,1297
411082000814,811,87,0,0,898,1947
411082000815,256,50,0,0,306,1319
411082000816,257,68,0,0,325,1489
411082000817,868,184,0,0,1052,814
411082000818,1228,171,0,0,1399,753
411082000819,455,116,0,0,571,698
411082000820,748,162,0,0,910,834
411082001048,17,2,0,0,19,110
411082001296,1679,231,0,0,1910,1025
411082001342,126,27,0,0,153,386
411082001440,636,72,0,0,708,1819
411082001441,322,23,0,0,345,440
411082001442,381,25,0,0,406,459
411082001443,322,63,0,0,385,518
411082001444,386,16,0,0,402,432
411082001497,260,32,0,0,292,388
411082001536,13,0,0,0,13,95
411082001600,278,41,0,0,319,526
411082001683,52,17,0,0,69,156
411082001717,126,20,0,0,146,99
411082001738,262,22,0,0,284,146
411082001805,131,52,0,0,183,1157
411082001809,173,24,0,0,197,656
411082001819,233,49,0,0,282,595
411082001826,455,20,0,0,475,586
411082004191,473,151,0,0,624,800
411082004192,145,29,0,0,174,283
411082004193,20,8,0,0,28,48
411082004194,65,19,0,0,84,164
411089000096,53,29,0,0,82,215
411089000103,133,39,0,0,172,390
411089000104,93,31,0,0,124,811
411089000106,194,49,0,0,243,338
411089000107,138,34,0,0,172,450
411089000108,126,36,0,0,162,737
411089000149,334,105,0,0,439,670
411089001297,93,33,0,0,126,362
411089001453,36,9,0,0,45,179
411089001799,33,10,0,0,43,160
411098000168,96,29,0,0,125,207
411098000169,117,20,0,0,137,883
411098000170,56,11,0,0,67,99
411098000171,79,13,0,0,92,646
411098000172,156,40,0,0,196,271
411098001011,34,7,0,0,41,131
411098001542,0,0,0,0,0,NA
411104000716,99,19,0,0,118,284
411104000717,47,9,0,0,56,291
411104000718,64,8,0,0,72,118
411104001494,0,0,0,0,0,NA
411104001818,0,0,0,0,0,NA
411110000159,155,35,0,0,190,694
411110000161,305,52,0,0,357,472
411110000162,160,24,0,0,184,316
411110000163,190,39,0,0,229,230
411110001857,0,0,0,0,0,NA
411122001285,332,48,0,0,380,666
411122001287,116,23,0,0,139,110
411122001450,20,8,0,0,28,18
411122001803,0,0,0,0,0,NA
411125001068,104,30,0,0,134,256
411129000679,59,23,0,0,82,582
411129001244,122,43,0,0,165,536
411129001245,101,37,0,0,138,1347
411129001246,172,71,0,0,243,809
411129001501,31,14,0,0,45,646
411129001684,0,0,0,0,0,NA
411129001772,69,17,0,0,86,632
411129001788,33,9,0,0,42,980
411140001381,146,7,0,0,153,232
411145000127,120,24,0,0,144,438
411145000762,152,33,0,0,185,NA
411145000763,177,35,0,0,212,855
411145000764,183,52,0,0,235,766
411145000766,0,0,0,0,0,NA
411145000822,33,12,0,0,45,112
411145000825,0,0,0,0,0,NA
411145000829,0,0,0,0,0,NA
411145000830,66,15,0,0,81,154
411145000840,42,22,0,0,64,168
411145000852,0,0,0,0,0,38
411145000857,463,159,0,0,622,607
411145001769,27,12,0,0,39,16
411149000073,99,14,0,0,113,191
411149000283,105,30,0,0,135,245
411149000943,69,26,0,0,95,571
411158000608,292,66,0,0,358,441
411158000609,47,10,0,0,57,79
411158000611,213,58,0,0,271,424
411158000612,53,15,0,0,68,60
411158000613,60,9,0,0,69,42
411158000614,275,84,0,0,359,1062
411158000615,339,91,0,0,430,301
411158001390,61,5,0,0,66,14
411158001677,0,0,0,0,0,NA
411158001727,0,0,0,0,0,NA
411161000309,155,23,0,0,178,236
411161000310,207,34,0,0,241,315
411161000311,169,38,0,0,207,581
411161000312,181,23,0,0,204,261
411161000313,181,45,0,0,226,156
411164001255,37,4,0,0,41,12
411167000578,263,32,0,0,295,296
411167000579,262,28,0,0,290,362
411167000580,244,41,0,0,285,381
411167000582,336,30,0,0,366,353
411167000583,278,23,0,0,301,261
411167000586,293,52,0,0,345,302
411167000587,164,23,0,0,187,473
411167000588,67,11,0,0,78,162
411167000589,156,36,0,0,192,385
411167000590,240,38,0,0,278,829
411167000591,526,59,0,0,585,1169
411167000593,183,38,0,0,221,1024
411167000594,731,115,0,0,846,493
411167000595,438,96,0,0,534,579
411167000973,389,48,0,0,437,446
411167000977,315,76,0,0,391,1025
411167000978,56,6,0,0,62,13
411167001330,194,31,0,0,225,461
411167001525,191,35,0,0,226,343
411167001641,137,21,0,0,158,158
411167001815,369,38,0,0,407,420
411172000189,92,11,0,0,103,304
411172000193,222,37,0,0,259,699
411172000195,140,46,0,0,186,810
411172000196,199,37,0,0,236,407
411172001599,32,9,0,0,41,38
411172001732,42,10,0,0,52,139
411172004195,248,62,0,0,310,602
411176000823,36,10,0,0,46,122
411176000824,20,3,0,0,23,29
411179001119,127,30,0,0,157,203
411179001120,127,43,0,0,170,295
411191000368,0,0,0,0,0,NA
411194000338,226,46,0,0,272,199
411194000339,106,21,0,0,127,412
411194000340,176,31,0,0,207,614
411194000341,169,31,0,0,200,146
411194001849,0,0,0,0,0,NA
411197000701,227,16,0,0,243,344
411197000702,208,23,0,0,231,366
411197000703,98,13,0,0,111,188
411197000706,193,23,0,0,216,342
411197000707,167,34,0,0,201,637
411197000708,290,55,0,0,345,300
411197001643,49,6,0,0,55,130
411224000381,244,72,0,0,316,1884
411224000440,385,84,0,0,469,855
411224001190,131,40,0,0,171,478
411224001191,151,33,0,0,184,554
411224001192,198,43,0,0,241,570
411224001193,329,47,0,0,376,681
411224001195,155,47,0,0,202,514
411224001196,210,53,0,0,263,1524
411224001197,245,57,0,0,302,2043
411224001198,407,135,0,0,542,891
411224001261,158,22,0,0,180,635
411224001298,77,15,0,0,92,546
411224001299,64,15,0,0,79,522
411224001331,199,48,0,0,247,501
411224001668,70,21,0,0,91,587
411224001722,50,4,0,0,54,82
411224004176,0,0,0,0,0,NA
411232001070,249,39,0,0,288,1028
411232001071,158,29,0,0,187,NA
411232001072,188,26,0,0,214,394
411232001074,164,23,0,0,187,657
411232001075,261,56,0,0,317,305
411236001150,0,0,0,0,0,NA
411254001122,0,0,0,0,0,NA
411260001090,212,31,0,0,243,493
411260001091,454,48,0,0,502,686
411260001092,294,38,0,0,332,180
411269001132,84,11,0,0,95,183
411269001133,40,20,0,0,60,124
411293000186,0,0,0,0,0,NA
411293000187,89,29,0,0,118,240
411293000188,60,21,0,0,81,58
411293001673,43,19,0,0,62,222
411299001147,21,15,0,0,36,54
411299001371,45,12,0,0,57,118
411308000166,317,68,0,0,385,909
411308000167,100,21,0,0,121,138
411317000053,40,5,0,0,45,133
411317000054,23,6,0,0,29,158
411317000055,43,16,0,0,59,304
411317000056,56,16,0,0,72,1200
411317000058,146,39,0,0,185,876
411317000574,221,73,0,0,294,590
411317001318,128,42,0,0,170,1087
411317001356,143,36,0,0,179,506
411317001377,73,18,0,0,91,588
411317001414,73,28,0,0,101,1506
411317001437,0,0,0,0,0,NA
411317001447,41,12,0,0,53,399
411317001575,195,40,0,0,235,565
411317001786,33,7,0,0,40,NA
411317001822,148,37,0,0,185,557
411317001825,33,15,0,0,48,630
411317001851,87,29,0,0,116,671
411335001276,294,34,0,0,328,489
411335001277,124,27,0,0,151,118
411335001338,75,6,0,0,81,235
411349000331,172,21,0,0,193,444
411349000333,79,17,0,0,96,187
411349000335,124,20,0,0,144,380
411349000336,185,40,0,0,225,163
411349001573,216,34,0,0,250,154
411349001828,14,1,0,0,15,NA
411353000841,331,41,0,0,372,460
411353000842,371,20,0,0,391,490
411353000843,538,48,0,0,586,818
411353000844,436,46,0,0,482,1256
411353001051,617,78,0,0,695,844
411353001052,465,79,0,0,544,1261
411353001546,88,19,0,0,107,140
411353001713,273,48,0,0,321,184
411353001714,192,18,0,0,210,96
411353001715,51,4,0,0,55,24
411353001723,235,29,0,0,264,147
411353001731,227,35,0,0,262,183
411365000319,100,16,0,0,116,150
411365000320,34,13,0,0,47,44
418018000230,46,5,0,0,51,NA
418018001510,18,2,0,0,20,NA
